1111121
1000101
1011101
1000001
1111011
1100001
1001101
1311111