121111111111
100000000001
101111011101
100000000001
101011111101
101011111101
101011111101
100000000001
111111111131