1111121
1000001
1011111
1000011
1011011
1011001
1001111
1131111