12111111111111111111
10001000000000000001
11101011100000000001
10101011100000000001
10000000000000000001
11110111100000000001
10000000000000000001
10000000000000000001
10111111010000000001
10101010011100000001
10000010110100000001
10000010000100000001
10000011111111100001
10000000000000000001
10000000000000000001
10000000000000000001
10000000000000000001
10000000000000000001
10000000000000000001
11111111111111111131