121111111111111111111111111111111111111111111111111111111111111
101000000000001000000010000000100000001000000010001000100000001
101011111111101011111010111110101111101011111010101010101111101
101000000000101010000010000010101000101010000010101010101000001
101111111110101010111111111010101010101010111110101010101011111
101000100000101010000010001010001010100010100000101010101010001
101010101111101011111010101011111010111110101111101010101010101
101010100000101010000010101000001010100000101000001010101010101
101010111110101010111110101111101010101111101011111010101010101
101010000000100010100010101000001010100000001000000010001010101
101011111111111110101010101011111010111111111111111111111010101
101000001000000010101010101000000010000000001000000010001010101
101111101011111010101010101111111111111111101011111010101010101
101000001000001010101000100000000010000000101010001010101010101
101011111111101010101111111111111010111110101010101010101010101
101010001000001010100000000010000010100010101010101010100010101
101010101011111010111111111010111110101010101010101010111110101
101010101000001010000010001010000010101010101010100010000000101
101010101111101011111010101011111010101010101010111111111111101
101000100000101000000010101000001010101010100010100000000000001
101111111110101111111110101111101010101010111110101111111111111
100000000000101000000000101000001010101010100000100000100010001
111111111111101011111111101011111010101010101111111110101010101
100000000000001010001000101000001010001010101000000010101010101
101111111111111010101010101111101011111010101011111010101010101
100000000000000010101010100000101000000010101010000010001000101
111111111111111110101010111110101111111110101010111111111111101
100000000000000000101010000000101000100010100010000010000000101
101111111111111111101011111111101010101010111111111010111110101
101000000000000000101000000000101010101010000010000010100010101
101011111111111110101111111110101010101011111010111110101010101
101010001000000000100000100000100010101010001010000010101010001
101010101011111111111110101111111110101010101011111010101011111
100010101000001000000010100000000010101010101000000010001010001
111110101111101011111010111111111010101010101111111111111010101
100010101000001010001010000000001010001000101000000000000010101
101010101011111010101011111111101011111111101011111111111110101
101010101000000010101010000000001010001000001000001000100000101
101010101111111110101010111111111010101011111111101010101111101
101000100000000010100010000000001010101010000000101010100000101
101111111111111010111111111111101010101010111110101010111110101
101000000010000010100010001000001000101010100010100010000000101
101011111010111110101010101011111111101010101010111111111111101
101010001010000000101010101000000000001010101010100010000000001
101010101011111111101010101111111111111010101010101010111111111
100010101000000000001010100000000000000010101000101010000010001
111110101111111111111010111111111111111110101111101011111010101
100000101000000000000010100000000000000010100000001010000010101
101111101011111111111110101111111111111010111111111010111110101
101000001000000000000010100000000010001010100000000010100000101
101011111111111111111010111111111010101010101111111110101111101
101000000000000000000010000010001010101010100000000000100000101
101111111111111111111111111010101010101010111111111111111110101
101000000010000000000000000010101010100010000010001000000010101
101011111010111111111111111110101010111111111010101011111010101
101000001010000010000000000010100010000000000010101000001010101
101111101011111010111111111010111111111111111110101111101010101
100000101000000010000010001010100010001000100010100000001010101
111110101111111111111010101010101010101010101010111111111010101
100000100000100000000010101000101010101010101010000000001010101
101111111110101111111110101111101010101010101011111111101010101
100000000000100000000000100000001000100010001000000000001000101
111111111111111111111111111111111111111111111111111111111111131